ATTENTION READERS/USERS OF THIS DOCUMENT!
All credit and thanks for compiling this dictionary dataset goes to Marco Forzati.

a = a
abasia = abbazia
val = valle
ala = ala
altare = altare
amùr = amore
an = anno
andà = andare
anima = anima
aqua = acqua; pioggia
arabià = arrabbiare; ~s = arrabbiarsi
arancia = arancia
arancio = arancione
aria = aria
armilì = mignolo
aròst = arrosto
articiòc = carciofo
asé = abbastanza
argàgn = aggeggio
arzènt = argento
autobus = autobus
baga = pancia
baghèt = cornamusa lombarda con due soli bordoni
baià = abbaiare
baita = baita, casa
bala = palla; balla, bugia; ubriacatura: ciapà 'na bröta ~ = ubriacarsi seriamente; palla, testicolo: che ~ = che palle; balla: bala de fé= balla di fieno; ~ = gioco praticato in piazza specie in al rompia, battendo una palla da tennis con le mani
balcù = balcone
balòs = monello, birichino
balù = pallone
barba = barba; briccone, brigante
barbài = cianfrusaglia, oggetto inutile
bas = basso
basa = bassa bresciana: la parte di provincia in pianura
bazia = ciotola
bazà = baciare
bèl = bello
biànc = bianco; bianco
bigà = litigare
bigaröl = grembiule
bigol = spaghetto ; groppo; ombelico, pene; persona di scarsa personalità e serietà; ~ d'ai = testa d'aglio
biròcc = calesse
blö = blu
blu böba = upupa, tonto
borlà = cadere
bòsgia = bugia; truciolo da pialla del legno
bòt = botto, l'una
bòta = botta
bras = braccio
brasà sö = abbracciare
bröt = brutto
ca' = casa, focolare domestico: me 'ndó a ca' = io vado a casa
ca = cane
caàl = cavallo
cagà = cagare
cal = callo
calsèt = calza
calt = caldo
capo = capo
car = caro
car = carro
casada = cazzata
caso = cazzo
caza = casa, edificio adibito ad abitazione: el gà 'na bèla ~ = ha una bella casa
cazo = caso
cél = cielo
ché = qui
che = che
ciaà = chiavare: scopare; fregare
ciàncol = tipico gioco in legno; persona poco seria
ciapà = prendere
ciar = chiaro
cicà = sputare
cicada = sputo
có = testa, capo: en ~ al mónt = in capo al mondo
coióni = coglioni, testicoli: he ~ = che coglioni
conécc = coniglio
cöntà = contare; raccontare;
cua = coda
cügià = cucchiaio
cügiàr = cucchiaio
cül = culo
cürt = corto
dé = giorno;
de = di, da
denàcc = davanti, denàcc de =davanti a
dés = dieci
di = dire; di sö = dire, recitare
didàl = ditale
disdòt = diciotto
disionare = dizionario
disnöf = diciannove
dit = dito
dizisèt = diciassette
domà = domani; pasàt ~ = dopodomani
dò = due
dòpo = dopo
du = due
dudes = dodici
dür = duro
düzì = dovere
e = e
en = in
encö = oggi: ~ dopomesdé = oggi pomeriggio
encülà = inculare; fregare: el m'a ~t = mi ha fregato; : encület! va a fat ~! = vaffanculo!
ensèma = insieme
entréc = intero
fa = fare
fés = molto
fiàt = alito, fiato
fóbal = gioco del calcio; pallone
frèsa = fretta
frèt = freddo
gatìgol = solletico
ghèba = nebbia fitta
ghidàs = padrino
ghidàsa = madrina
giér = ieri; ~ pasàt = l’altro ieri
girà = girare; girare
giü = uno
gometà = vomitare
gombèt = gomito
grant = grande
gras = grasso; grasso
gregnapola = pipistrello
gróp = nodo
gròs = grosso, dit ~ = pollice
idèa = idea
iga = avere; ~ de = dover : gó de na = devo andare
istès = uguale, lo stesso
la = la
là = là
lac = lago
laorà = lavorare
larc = largo
lart = lardo
lasà = lasciare
laùr = cosa
lé = lì
lià = levare, alzare; ~ sö = alzarsi
lónc = lungo
luì = ombelico
ma = ma
magher = magro
magut = muratore
mai = mai
mal = male
malghés = malghese, mandriano
malmadür = immaturo
malmustùs = malmostoso, scorbutico, musone
malnada = malnata
malnàt = malnato
manèsa = maniglia
mangià = mangiare
manöal = manovale
maola = fragola
mar = mare
maringù = falegname
martinèl = calabrone
marù = marrone; marrone ; testicoli
mé = io, me
menà = menare, accompagnare; menare, picchiare
mès = mezzo
més = mese
mile = mille
miliardo = miliardo
miliù = milione
mòl = molle; mòl del pa = mollica
mònega = monaca
moscaröla = dispensa pensile con zanzariera
moségn = moccio
muruze = lett.: morose, fidanzate;
andà ~ = uscire con qualcuno , avere una relazione
naser = nascere
nèbia = nebbia
nèdra = anitra
néf = neve
negà = annegare; negare
négher = nero; nero
nigol = nuvola; nuvoloso
nò = no
no = non
nòt = notte
noanta = novanta
novantü = novantuno
nöf = nuovo
nöf = nove
nóter = noi
óbet = funerale
ólta = volta: 'na ~ = una volta; volta, arco;
oltà = voltare
ónda = onda; de ónda = veloce
öndès = undici
òstrega = accidenti, caspita
òt = otto
otanta = ottanta
otantü = ottantuno
otomana = divano
ozèl = uccello; pene, uccello
polènta e ozèi = polenta è uccelli
palmös = palmo
paiàso = pagliaccio
panèl = gradino
papina = sberla
paröl = pentola
pasà = passare
pasàt = ; scorso: l’an ~ = l’anno scorso; appassito, non più maturo, andato a male: chèi pér lé i’è pasàcc
pè = piede
peerù = peperone
pégher = lento, pigro
pégora = pecora
pér = pero; pera
per = per
perù = forchetta
pesada = calcio, pedata
pesèn = piccolo
picinì = piccolo, piccolino
piè = pieno
piöer = piovere
pirlo - capriola; pirlo, spritz
pisà = pisciare
pò = poi; pò dòpo = poi
pó = po'
póc = poco
pögn = pugno
polènta = polenta
póm = mela
pòm grà = melograno
póra = paura
prét = prete
pucià = spingere
pulmù = polmone
pultruna = poltrona
qual = quale
quant = quando
quaranta = quaranta; quarantü = quarantuno
quater = quattro
quatórdes = quattordici
quindes = quindici
rabià = arrabbiare; ~s = arrabbiarsi
restèl = cancello
ria = riva
rià = arrivare; riuscire
réf = refe, filo
rós = rosso; rosso
ròs = un sacco di: en ~ de pégore = un sacco di pecore
róza = rosa; rosa
rözen = ruggine
ruinà = rovinare
sacagnàt = rotto, malmesso
sera = sera
seréza : ciliegia
saàta = ciabatta
sbasà = abbassare; ~s = abbassarsi
sbüzà = bucare
scagna = sedia
scaldà = scaldare
scalfarèt = calza fatta in casa
scarsèla = tasca
scciafù = schiaffo
scöla = scuola
scorezà = scoreggiare
scorèza = scoreggia
scür = scuro
sécia = secchio
sédes = sedici
sènt = cento
sércol = cerchio
sés = sei
sesanta = sessanta; sesantü = sessantuno
sèt = sette
setanta = settanta; setantü = settantuno
setemana = settimana
sic = cinque
sicér = lavandino
sina = scrofa
sintàs = sedersi
smargàgn = catarro; sputo
smontà = smontare; scendere da
sö = su
söbra = ciabatta chiusa davanti
sòc = ceppo
söca = zucca
söla = suola
sòlit = solito, de ~ = di solito
spüdà = sputare
spüt = sputo
stagn = duro, resistente; stagno
straacà = versar fuori, rovesciare; tracimare
strèt = stretto
stròpa = frustino fatto con fuscelli
sul = sole; solo
suprisì = ferro da stiro
svèlto = veloce, svelto
tacà = comiciare; attaccare, incollare; ~ vià = appendere
taià = tagliare; smettere, tagliare
talamora = ragnatela
tant = tanto
taol = tavolo
tàola = tavola
tartaià = tartagliare, balbettare
tè = the
té = tu, te
tèner = tenero: morbido, soffice
tèra = terra
terù = terrone, persona dal ud talia; del ud talia
tirà = lanciare; tirare
tirabusù = cavatappi
tö = prendere
tóla = latta, bidone; brutta figura
töt = tutto
trà = sparare
tré = tre
trédes = tredici
trènta = trenta; trentü = trentuno
turna = ancora, nuovamente, amò ~ = ancora una volta
turnà = tornare, ritornare; ripetere un'azione: l'è ~t a sbaglià = ha sbagliato un'altra volta
Üs = abituato
uzà = urlare
uzmà = apprezzare, trovare paicevole: el me uzma mia = non gli piaccio proprio
val = valle
vècc = vecchio, vecchia
vègner = venire
vért = verde; verde
vint = venti; ~ü = ventuno; ~i-dù/tré… = venti-due/tre…
völer = volere
vöt = vuoto
zaài = cianfrusaglia
zalt = giallo; giallo
zó = giù
zuen = giovane; giovane